

NO ./textures/north_texture.xpm
SO ./textures/south_texture.xpm
WE ./textures/west_texture.xpm
EA ./textures/east_texture.xpm


C 135,206,235

F 139,69,19

    1111111111111111
  111000000000000001
  110000000000111111
  111000000S000011
10000000000000011
1111111111111111