

NO ./textures/north_texture.xpm
SO ./textures/south_texture.xpm
WE ./textures/west_texture.xpm
EA ./textures/east_texture.xpm



C 135,206,235

F 139,69,19



        1111111111111111111111111
        1000000000110000001     1
        1011000001110000001     1
        1001000000000000001     1
111111111011000001110000001     1
100000000011000001110111111111111
11110111111111011100000010001
11110111111111011101010010001
11000000110101011100000010001
10000000000000001100000010001
100000000N0000001101010010001
110000011101010111110111100111
11110111 1110101 101111010001
11111111 1111111 111111111111
