
NO ./textures/north_texture.xpm
SO ./textures/south_texture.xpm
WE ./textures/west_texture.xpm
EA ./textures/east_texture.xpm


C 135,206,235

F 139,69,19

1111111111111111        1111111111111111  
1000000000000001        1000000000000001
10000000000111111111111111000000000011111
1000000S000010100000000001000000000001011
10000001000000011111111111000000100000001
1111111111111111        11111111111111111
