

NO ./textures/north_texture.xpm
SO ./textures/south_texture.xpm
WE ./textures/west_texture.xpm
EA ./textures/east_texture.xpm



F 139,69,19


1111111111111111
1000000000000001
1000000000011111
1000000S00000001
1000000000000001
1111111111111111
