

NO ./textures/north_texture.xpm
SO ./textures/south_texture.xpm
WE ./textures/west_texture.xpm
EA ./textures/east_texture.xpm


C 135,206,235

F 139,69,19

1111111111111111111111111
1000000000110000000000001
10110000011100000N0000001
1001000000000000000000001
1111111101111111000011111
1000100000000000000000011
1111111111111111111111111
