

NO ./textures/north_texture.xpm
SO ./textures/south_texture.xpm
WE ./textures/west_texture.xpm
EA ./textures/east_texture.xpm


C 135,206,235

F 139,69,19

      111111
 111111111111111
1000000000000001
1000000000011111
111000000S000011
1000000000000001
1111111111111111
