

NO ./textures/north_texture.xpm
SO ./textures/south_texture.xpm
WE ./textures/west_texture.xpm
EA ./textures/east_texture.xpm


C 135,206,235

F 139,69,19

        1111111111111111111111111
        1000000000110000000000001
        101100000111000000000000111111111
        11111110010000000000000000000011
    1111111111101100000111000000000000111
   1100000000011000001110111111111111111
 11110111111111011100000010001111
    11110111111111011101010010001
 11111000000110101011100000010001
 10000000000000001100000010001111
 10000000000000001101010N10001
 11000001110101011111011110011
 11110111 1110101 101111010001
 11111111 1111111 111111111111